#ID	first	second	third
Metabolism.Carbohydrate_metabolism.Glycolysis_Gluconeogenesis	L1__Metabolism	L2__Carbohydrate_metabolism	L3__Glycolysis_Gluconeogenesis
Metabolism.Carbohydrate_metabolism.Citrate_cycle_(TCA_cycle)	L1__Metabolism	L2__Carbohydrate_metabolism	L3__Citrate_cycle_(TCA_cycle)
Metabolism.Carbohydrate_metabolism.Pentose_phosphate_pathway	L1__Metabolism	L2__Carbohydrate_metabolism	L3__Pentose_phosphate_pathway
Metabolism.Carbohydrate_metabolism.Pentose_and_glucuronate_interconversions	L1__Metabolism	L2__Carbohydrate_metabolism	L3__Pentose_and_glucuronate_interconversions
Metabolism.Carbohydrate_metabolism.Fructose_and_mannose_metabolism	L1__Metabolism	L2__Carbohydrate_metabolism	L3__Fructose_and_mannose_metabolism
Metabolism.Carbohydrate_metabolism.Galactose_metabolism	L1__Metabolism	L2__Carbohydrate_metabolism	L3__Galactose_metabolism
Metabolism.Carbohydrate_metabolism.Ascorbate_and_aldarate_metabolism	L1__Metabolism	L2__Carbohydrate_metabolism	L3__Ascorbate_and_aldarate_metabolism
Metabolism.Lipid_metabolism.Fatty_acid_biosynthesis	L1__Metabolism	L2__Lipid_metabolism	L3__Fatty_acid_biosynthesis
Metabolism.Lipid_metabolism.Fatty_acid_elongation	L1__Metabolism	L2__Lipid_metabolism	L3__Fatty_acid_elongation
Metabolism.Lipid_metabolism.Fatty_acid_degradation	L1__Metabolism	L2__Lipid_metabolism	L3__Fatty_acid_degradation
Metabolism.Lipid_metabolism.Primary_bile_acid_biosynthesis	L1__Metabolism	L2__Lipid_metabolism	L3__Primary_bile_acid_biosynthesis
Metabolism.Lipid_metabolism.Secondary_bile_acid_biosynthesis	L1__Metabolism	L2__Lipid_metabolism	L3__Secondary_bile_acid_biosynthesis
Metabolism.Metabolism_of_cofactors_and_vitamins.Ubiquinone_and_other_terpenoid__quinone_biosynthesis	L1__Metabolism	L2__Metabolism_of_cofactors_and_vitamins	L3__Ubiquinone_and_other_terpenoid__quinone_biosynthesis
Metabolism.Lipid_metabolism.Steroid_hormone_biosynthesis	L1__Metabolism	L2__Lipid_metabolism	L3__Steroid_hormone_biosynthesis
Metabolism.Energy_metabolism.Oxidative_phosphorylation	L1__Metabolism	L2__Energy_metabolism	L3__Oxidative_phosphorylation
Metabolism.Amino_acid_metabolism.Arginine_biosynthesis	L1__Metabolism	L2__Amino_acid_metabolism	L3__Arginine_biosynthesis
Metabolism.Nucleotide_metabolism.Purine_metabolism	L1__Metabolism	L2__Nucleotide_metabolism	L3__Purine_metabolism
Metabolism.Nucleotide_metabolism.Pyrimidine_metabolism	L1__Metabolism	L2__Nucleotide_metabolism	L3__Pyrimidine_metabolism
Metabolism.Amino_acid_metabolism.Alanine,_aspartate_and_glutamate_metabolism	L1__Metabolism	L2__Amino_acid_metabolism	L3__Alanine,_aspartate_and_glutamate_metabolism
Metabolism.Amino_acid_metabolism.Glycine,_serine_and_threonine_metabolism	L1__Metabolism	L2__Amino_acid_metabolism	L3__Glycine,_serine_and_threonine_metabolism
Metabolism.Biosynthesis_of_other_secondary_metabolites.Monobactam_biosynthesis	L1__Metabolism	L2__Biosynthesis_of_other_secondary_metabolites	L3__Monobactam_biosynthesis
Metabolism.Amino_acid_metabolism.Cysteine_and_methionine_metabolism	L1__Metabolism	L2__Amino_acid_metabolism	L3__Cysteine_and_methionine_metabolism
Metabolism.Amino_acid_metabolism.Valine,_leucine_and_isoleucine_degradation	L1__Metabolism	L2__Amino_acid_metabolism	L3__Valine,_leucine_and_isoleucine_degradation
Metabolism.Metabolism_of_terpenoids_and_polyketides.Geraniol_degradation	L1__Metabolism	L2__Metabolism_of_terpenoids_and_polyketides	L3__Geraniol_degradation
Metabolism.Amino_acid_metabolism.Valine,_leucine_and_isoleucine_biosynthesis	L1__Metabolism	L2__Amino_acid_metabolism	L3__Valine,_leucine_and_isoleucine_biosynthesis
Metabolism.Amino_acid_metabolism.Lysine_biosynthesis	L1__Metabolism	L2__Amino_acid_metabolism	L3__Lysine_biosynthesis
Metabolism.Amino_acid_metabolism.Lysine_degradation	L1__Metabolism	L2__Amino_acid_metabolism	L3__Lysine_degradation
Metabolism.Biosynthesis_of_other_secondary_metabolites.Penicillin_and_cephalosporin_biosynthesis	L1__Metabolism	L2__Biosynthesis_of_other_secondary_metabolites	L3__Penicillin_and_cephalosporin_biosynthesis
Metabolism.Amino_acid_metabolism.Arginine_and_proline_metabolism	L1__Metabolism	L2__Amino_acid_metabolism	L3__Arginine_and_proline_metabolism
Metabolism.Amino_acid_metabolism.Histidine_metabolism	L1__Metabolism	L2__Amino_acid_metabolism	L3__Histidine_metabolism
Metabolism.Amino_acid_metabolism.Tyrosine_metabolism	L1__Metabolism	L2__Amino_acid_metabolism	L3__Tyrosine_metabolism
Metabolism.Amino_acid_metabolism.Phenylalanine_metabolism	L1__Metabolism	L2__Amino_acid_metabolism	L3__Phenylalanine_metabolism
Metabolism.Xenobiotics_biodegradation_and_metabolism.Chlorocyclohexane_and_chlorobenzene_degradation	L1__Metabolism	L2__Xenobiotics_biodegradation_and_metabolism	L3__Chlorocyclohexane_and_chlorobenzene_degradation
Metabolism.Xenobiotics_biodegradation_and_metabolism.Benzoate_degradation	L1__Metabolism	L2__Xenobiotics_biodegradation_and_metabolism	L3__Benzoate_degradation
Metabolism.Xenobiotics_biodegradation_and_metabolism.Fluorobenzoate_degradation	L1__Metabolism	L2__Xenobiotics_biodegradation_and_metabolism	L3__Fluorobenzoate_degradation
Metabolism.Amino_acid_metabolism.Tryptophan_metabolism	L1__Metabolism	L2__Amino_acid_metabolism	L3__Tryptophan_metabolism
Metabolism.Amino_acid_metabolism.Phenylalanine,_tyrosine_and_tryptophan_biosynthesis	L1__Metabolism	L2__Amino_acid_metabolism	L3__Phenylalanine,_tyrosine_and_tryptophan_biosynthesis
Metabolism.Metabolism_of_other_amino_acids.beta__Alanine_metabolism	L1__Metabolism	L2__Metabolism_of_other_amino_acids	L3__beta__Alanine_metabolism
Metabolism.Metabolism_of_other_amino_acids.Taurine_and_hypotaurine_metabolism	L1__Metabolism	L2__Metabolism_of_other_amino_acids	L3__Taurine_and_hypotaurine_metabolism
Metabolism.Metabolism_of_other_amino_acids.Phosphonate_and_phosphinate_metabolism	L1__Metabolism	L2__Metabolism_of_other_amino_acids	L3__Phosphonate_and_phosphinate_metabolism
Metabolism.Metabolism_of_other_amino_acids.Selenocompound_metabolism	L1__Metabolism	L2__Metabolism_of_other_amino_acids	L3__Selenocompound_metabolism
Metabolism.Metabolism_of_other_amino_acids.D__Amino_acid_metabolism	L1__Metabolism	L2__Metabolism_of_other_amino_acids	L3__D__Amino_acid_metabolism
Metabolism.Metabolism_of_other_amino_acids.Glutathione_metabolism	L1__Metabolism	L2__Metabolism_of_other_amino_acids	L3__Glutathione_metabolism
Metabolism.Carbohydrate_metabolism.Starch_and_sucrose_metabolism	L1__Metabolism	L2__Carbohydrate_metabolism	L3__Starch_and_sucrose_metabolism
Metabolism.Glycan_biosynthesis_and_metabolism.Other_glycan_degradation	L1__Metabolism	L2__Glycan_biosynthesis_and_metabolism	L3__Other_glycan_degradation
Metabolism.Carbohydrate_metabolism.Amino_sugar_and_nucleotide_sugar_metabolism	L1__Metabolism	L2__Carbohydrate_metabolism	L3__Amino_sugar_and_nucleotide_sugar_metabolism
Metabolism.Biosynthesis_of_other_secondary_metabolites.Streptomycin_biosynthesis	L1__Metabolism	L2__Biosynthesis_of_other_secondary_metabolites	L3__Streptomycin_biosynthesis
Metabolism.Metabolism_of_terpenoids_and_polyketides.Polyketide_sugar_unit_biosynthesis	L1__Metabolism	L2__Metabolism_of_terpenoids_and_polyketides	L3__Polyketide_sugar_unit_biosynthesis
Metabolism.Biosynthesis_of_other_secondary_metabolites.Acarbose_and_validamycin_biosynthesis	L1__Metabolism	L2__Biosynthesis_of_other_secondary_metabolites	L3__Acarbose_and_validamycin_biosynthesis
Metabolism.Glycan_biosynthesis_and_metabolism.Glycosaminoglycan_degradation	L1__Metabolism	L2__Glycan_biosynthesis_and_metabolism	L3__Glycosaminoglycan_degradation
Metabolism.Glycan_biosynthesis_and_metabolism.Lipopolysaccharide_biosynthesis	L1__Metabolism	L2__Glycan_biosynthesis_and_metabolism	L3__Lipopolysaccharide_biosynthesis
Metabolism.Glycan_biosynthesis_and_metabolism.O__Antigen_nucleotide_sugar_biosynthesis	L1__Metabolism	L2__Glycan_biosynthesis_and_metabolism	L3__O__Antigen_nucleotide_sugar_biosynthesis
Metabolism.Glycan_biosynthesis_and_metabolism.Exopolysaccharide_biosynthesis	L1__Metabolism	L2__Glycan_biosynthesis_and_metabolism	L3__Exopolysaccharide_biosynthesis
Metabolism.Glycan_biosynthesis_and_metabolism.Peptidoglycan_biosynthesis	L1__Metabolism	L2__Glycan_biosynthesis_and_metabolism	L3__Peptidoglycan_biosynthesis
Metabolism.Glycan_biosynthesis_and_metabolism.Teichoic_acid_biosynthesis	L1__Metabolism	L2__Glycan_biosynthesis_and_metabolism	L3__Teichoic_acid_biosynthesis
Metabolism.Lipid_metabolism.Glycerolipid_metabolism	L1__Metabolism	L2__Lipid_metabolism	L3__Glycerolipid_metabolism
Metabolism.Carbohydrate_metabolism.Inositol_phosphate_metabolism	L1__Metabolism	L2__Carbohydrate_metabolism	L3__Inositol_phosphate_metabolism
Metabolism.Lipid_metabolism.Glycerophospholipid_metabolism	L1__Metabolism	L2__Lipid_metabolism	L3__Glycerophospholipid_metabolism
Metabolism.Lipid_metabolism.Ether_lipid_metabolism	L1__Metabolism	L2__Lipid_metabolism	L3__Ether_lipid_metabolism
Metabolism.Glycan_biosynthesis_and_metabolism.Lipoarabinomannan_(LAM)_biosynthesis	L1__Metabolism	L2__Glycan_biosynthesis_and_metabolism	L3__Lipoarabinomannan_(LAM)_biosynthesis
Metabolism.Glycan_biosynthesis_and_metabolism.Arabinogalactan_biosynthesis__Mycobacterium	L1__Metabolism	L2__Glycan_biosynthesis_and_metabolism	L3__Arabinogalactan_biosynthesis__Mycobacterium
Metabolism.Lipid_metabolism.Arachidonic_acid_metabolism	L1__Metabolism	L2__Lipid_metabolism	L3__Arachidonic_acid_metabolism
Metabolism.Lipid_metabolism.Sphingolipid_metabolism	L1__Metabolism	L2__Lipid_metabolism	L3__Sphingolipid_metabolism
Metabolism.Glycan_biosynthesis_and_metabolism.Glycosphingolipid_biosynthesis__globo_and_isoglobo_series	L1__Metabolism	L2__Glycan_biosynthesis_and_metabolism	L3__Glycosphingolipid_biosynthesis__globo_and_isoglobo_series
Metabolism.Carbohydrate_metabolism.Pyruvate_metabolism	L1__Metabolism	L2__Carbohydrate_metabolism	L3__Pyruvate_metabolism
Metabolism.Xenobiotics_biodegradation_and_metabolism.Dioxin_degradation	L1__Metabolism	L2__Xenobiotics_biodegradation_and_metabolism	L3__Dioxin_degradation
Metabolism.Xenobiotics_biodegradation_and_metabolism.Xylene_degradation	L1__Metabolism	L2__Xenobiotics_biodegradation_and_metabolism	L3__Xylene_degradation
Metabolism.Xenobiotics_biodegradation_and_metabolism.Aminobenzoate_degradation	L1__Metabolism	L2__Xenobiotics_biodegradation_and_metabolism	L3__Aminobenzoate_degradation
Metabolism.Carbohydrate_metabolism.Glyoxylate_and_dicarboxylate_metabolism	L1__Metabolism	L2__Carbohydrate_metabolism	L3__Glyoxylate_and_dicarboxylate_metabolism
Metabolism.Xenobiotics_biodegradation_and_metabolism.Nitrotoluene_degradation	L1__Metabolism	L2__Xenobiotics_biodegradation_and_metabolism	L3__Nitrotoluene_degradation
Metabolism.Carbohydrate_metabolism.Propanoate_metabolism	L1__Metabolism	L2__Carbohydrate_metabolism	L3__Propanoate_metabolism
Metabolism.Xenobiotics_biodegradation_and_metabolism.Styrene_degradation	L1__Metabolism	L2__Xenobiotics_biodegradation_and_metabolism	L3__Styrene_degradation
Metabolism.Carbohydrate_metabolism.Butanoate_metabolism	L1__Metabolism	L2__Carbohydrate_metabolism	L3__Butanoate_metabolism
Metabolism.Carbohydrate_metabolism.C5__Branched_dibasic_acid_metabolism	L1__Metabolism	L2__Carbohydrate_metabolism	L3__C5__Branched_dibasic_acid_metabolism
Metabolism.Metabolism_of_cofactors_and_vitamins.One_carbon_pool_by_folate	L1__Metabolism	L2__Metabolism_of_cofactors_and_vitamins	L3__One_carbon_pool_by_folate
Metabolism.Energy_metabolism.Methane_metabolism	L1__Metabolism	L2__Energy_metabolism	L3__Methane_metabolism
Metabolism.Energy_metabolism.Carbon_fixation_in_photosynthetic_organisms	L1__Metabolism	L2__Energy_metabolism	L3__Carbon_fixation_in_photosynthetic_organisms
Metabolism.Energy_metabolism.Carbon_fixation_pathways_in_prokaryotes	L1__Metabolism	L2__Energy_metabolism	L3__Carbon_fixation_pathways_in_prokaryotes
Metabolism.Metabolism_of_cofactors_and_vitamins.Thiamine_metabolism	L1__Metabolism	L2__Metabolism_of_cofactors_and_vitamins	L3__Thiamine_metabolism
Metabolism.Metabolism_of_cofactors_and_vitamins.Riboflavin_metabolism	L1__Metabolism	L2__Metabolism_of_cofactors_and_vitamins	L3__Riboflavin_metabolism
Metabolism.Metabolism_of_cofactors_and_vitamins.Vitamin_B6_metabolism	L1__Metabolism	L2__Metabolism_of_cofactors_and_vitamins	L3__Vitamin_B6_metabolism
Metabolism.Metabolism_of_cofactors_and_vitamins.Nicotinate_and_nicotinamide_metabolism	L1__Metabolism	L2__Metabolism_of_cofactors_and_vitamins	L3__Nicotinate_and_nicotinamide_metabolism
Metabolism.Metabolism_of_cofactors_and_vitamins.Pantothenate_and_CoA_biosynthesis	L1__Metabolism	L2__Metabolism_of_cofactors_and_vitamins	L3__Pantothenate_and_CoA_biosynthesis
Metabolism.Metabolism_of_cofactors_and_vitamins.Biotin_metabolism	L1__Metabolism	L2__Metabolism_of_cofactors_and_vitamins	L3__Biotin_metabolism
Metabolism.Metabolism_of_cofactors_and_vitamins.Lipoic_acid_metabolism	L1__Metabolism	L2__Metabolism_of_cofactors_and_vitamins	L3__Lipoic_acid_metabolism
Metabolism.Metabolism_of_cofactors_and_vitamins.Folate_biosynthesis	L1__Metabolism	L2__Metabolism_of_cofactors_and_vitamins	L3__Folate_biosynthesis
Metabolism.Metabolism_of_cofactors_and_vitamins.Retinol_metabolism	L1__Metabolism	L2__Metabolism_of_cofactors_and_vitamins	L3__Retinol_metabolism
Metabolism.Metabolism_of_cofactors_and_vitamins.Porphyrin_metabolism	L1__Metabolism	L2__Metabolism_of_cofactors_and_vitamins	L3__Porphyrin_metabolism
Metabolism.Metabolism_of_terpenoids_and_polyketides.Terpenoid_backbone_biosynthesis	L1__Metabolism	L2__Metabolism_of_terpenoids_and_polyketides	L3__Terpenoid_backbone_biosynthesis
Metabolism.Metabolism_of_terpenoids_and_polyketides.Limonene_and_pinene_degradation	L1__Metabolism	L2__Metabolism_of_terpenoids_and_polyketides	L3__Limonene_and_pinene_degradation
Metabolism.Energy_metabolism.Nitrogen_metabolism	L1__Metabolism	L2__Energy_metabolism	L3__Nitrogen_metabolism
Metabolism.Energy_metabolism.Sulfur_metabolism	L1__Metabolism	L2__Energy_metabolism	L3__Sulfur_metabolism
Metabolism.Xenobiotics_biodegradation_and_metabolism.Caprolactam_degradation	L1__Metabolism	L2__Xenobiotics_biodegradation_and_metabolism	L3__Caprolactam_degradation
Metabolism.Biosynthesis_of_other_secondary_metabolites.Tropane,_piperidine_and_pyridine_alkaloid_biosynthesis	L1__Metabolism	L2__Biosynthesis_of_other_secondary_metabolites	L3__Tropane,_piperidine_and_pyridine_alkaloid_biosynthesis
Genetic_Information_Processing.Translation.Aminoacyl__tRNA_biosynthesis	L1__Genetic_Information_Processing	L2__Translation	L3__Aminoacyl__tRNA_biosynthesis
Metabolism.Xenobiotics_biodegradation_and_metabolism.Metabolism_of_xenobiotics_by_cytochrome_P450	L1__Metabolism	L2__Xenobiotics_biodegradation_and_metabolism	L3__Metabolism_of_xenobiotics_by_cytochrome_P450
Metabolism.Xenobiotics_biodegradation_and_metabolism.Drug_metabolism__other_enzymes	L1__Metabolism	L2__Xenobiotics_biodegradation_and_metabolism	L3__Drug_metabolism__other_enzymes
Metabolism.Xenobiotics_biodegradation_and_metabolism.Steroid_degradation	L1__Metabolism	L2__Xenobiotics_biodegradation_and_metabolism	L3__Steroid_degradation
Metabolism.Lipid_metabolism.Biosynthesis_of_unsaturated_fatty_acids	L1__Metabolism	L2__Lipid_metabolism	L3__Biosynthesis_of_unsaturated_fatty_acids
Metabolism.Metabolism_of_terpenoids_and_polyketides.Biosynthesis_of_siderophore_group_nonribosomal_peptides	L1__Metabolism	L2__Metabolism_of_terpenoids_and_polyketides	L3__Biosynthesis_of_siderophore_group_nonribosomal_peptides
Human_Diseases.Drug_resistance_antimicrobial.beta__Lactam_resistance	L1__Human_Diseases	L2__Drug_resistance_antimicrobial	L3__beta__Lactam_resistance
Human_Diseases.Drug_resistance_antimicrobial.Vancomycin_resistance	L1__Human_Diseases	L2__Drug_resistance_antimicrobial	L3__Vancomycin_resistance
Human_Diseases.Drug_resistance_antimicrobial.Cationic_antimicrobial_peptide_(CAMP)_resistance	L1__Human_Diseases	L2__Drug_resistance_antimicrobial	L3__Cationic_antimicrobial_peptide_(CAMP)_resistance
Human_Diseases.Drug_resistance_antineoplastic.Endocrine_resistance	L1__Human_Diseases	L2__Drug_resistance_antineoplastic	L3__Endocrine_resistance
Human_Diseases.Drug_resistance_antineoplastic.Antifolate_resistance	L1__Human_Diseases	L2__Drug_resistance_antineoplastic	L3__Antifolate_resistance
Human_Diseases.Drug_resistance_antineoplastic.Platinum_drug_resistance	L1__Human_Diseases	L2__Drug_resistance_antineoplastic	L3__Platinum_drug_resistance
Environmental_Information_Processing.Membrane_transport.ABC_transporters	L1__Environmental_Information_Processing	L2__Membrane_transport	L3__ABC_transporters
Environmental_Information_Processing.Signal_transduction.Two__component_system	L1__Environmental_Information_Processing	L2__Signal_transduction	L3__Two__component_system
Cellular_Processes.Cellular_community__prokaryotes.Quorum_sensing	L1__Cellular_Processes	L2__Cellular_community__prokaryotes	L3__Quorum_sensing
Cellular_Processes.Cellular_community__prokaryotes.Biofilm_formation__Escherichia_coli	L1__Cellular_Processes	L2__Cellular_community__prokaryotes	L3__Biofilm_formation__Escherichia_coli
Cellular_Processes.Cell_motility.Bacterial_chemotaxis	L1__Cellular_Processes	L2__Cell_motility	L3__Bacterial_chemotaxis
Cellular_Processes.Cell_motility.Flagellar_assembly	L1__Cellular_Processes	L2__Cell_motility	L3__Flagellar_assembly
Environmental_Information_Processing.Membrane_transport.Phosphotransferase_system_(PTS)	L1__Environmental_Information_Processing	L2__Membrane_transport	L3__Phosphotransferase_system_(PTS)
Genetic_Information_Processing.Translation.Ribosome	L1__Genetic_Information_Processing	L2__Translation	L3__Ribosome
Genetic_Information_Processing.Folding,_sorting_and_degradation.RNA_degradation	L1__Genetic_Information_Processing	L2__Folding,_sorting_and_degradation	L3__RNA_degradation
Genetic_Information_Processing.Replication_and_repair.DNA_replication	L1__Genetic_Information_Processing	L2__Replication_and_repair	L3__DNA_replication
Genetic_Information_Processing.Folding,_sorting_and_degradation.Proteasome	L1__Genetic_Information_Processing	L2__Folding,_sorting_and_degradation	L3__Proteasome
Genetic_Information_Processing.Folding,_sorting_and_degradation.Protein_export	L1__Genetic_Information_Processing	L2__Folding,_sorting_and_degradation	L3__Protein_export
Environmental_Information_Processing.Membrane_transport.Bacterial_secretion_system	L1__Environmental_Information_Processing	L2__Membrane_transport	L3__Bacterial_secretion_system
Organismal_Systems.Endocrine_system.PPAR_signaling_pathway	L1__Organismal_Systems	L2__Endocrine_system	L3__PPAR_signaling_pathway
Genetic_Information_Processing.Replication_and_repair.Base_excision_repair	L1__Genetic_Information_Processing	L2__Replication_and_repair	L3__Base_excision_repair
Genetic_Information_Processing.Replication_and_repair.Nucleotide_excision_repair	L1__Genetic_Information_Processing	L2__Replication_and_repair	L3__Nucleotide_excision_repair
Genetic_Information_Processing.Replication_and_repair.Mismatch_repair	L1__Genetic_Information_Processing	L2__Replication_and_repair	L3__Mismatch_repair
Genetic_Information_Processing.Replication_and_repair.Homologous_recombination	L1__Genetic_Information_Processing	L2__Replication_and_repair	L3__Homologous_recombination
Environmental_Information_Processing.Signal_transduction.Calcium_signaling_pathway	L1__Environmental_Information_Processing	L2__Signal_transduction	L3__Calcium_signaling_pathway
Environmental_Information_Processing.Signal_transduction.cGMP__PKG_signaling_pathway	L1__Environmental_Information_Processing	L2__Signal_transduction	L3__cGMP__PKG_signaling_pathway
Environmental_Information_Processing.Signal_transduction.cAMP_signaling_pathway	L1__Environmental_Information_Processing	L2__Signal_transduction	L3__cAMP_signaling_pathway
Environmental_Information_Processing.Signal_transduction.HIF__1_signaling_pathway	L1__Environmental_Information_Processing	L2__Signal_transduction	L3__HIF__1_signaling_pathway
Environmental_Information_Processing.Signal_transduction.FoxO_signaling_pathway	L1__Environmental_Information_Processing	L2__Signal_transduction	L3__FoxO_signaling_pathway
Environmental_Information_Processing.Signal_transduction.Phosphatidylinositol_signaling_system	L1__Environmental_Information_Processing	L2__Signal_transduction	L3__Phosphatidylinositol_signaling_system
Environmental_Information_Processing.Signal_transduction.Phospholipase_D_signaling_pathway	L1__Environmental_Information_Processing	L2__Signal_transduction	L3__Phospholipase_D_signaling_pathway
Cellular_Processes.Cell_growth_and_death.Cell_cycle__Caulobacter	L1__Cellular_Processes	L2__Cell_growth_and_death	L3__Cell_cycle__Caulobacter
Cellular_Processes.Cell_growth_and_death.p53_signaling_pathway	L1__Cellular_Processes	L2__Cell_growth_and_death	L3__p53_signaling_pathway
Genetic_Information_Processing.Folding,_sorting_and_degradation.Ubiquitin_mediated_proteolysis	L1__Genetic_Information_Processing	L2__Folding,_sorting_and_degradation	L3__Ubiquitin_mediated_proteolysis
Genetic_Information_Processing.Folding,_sorting_and_degradation.Sulfur_relay_system	L1__Genetic_Information_Processing	L2__Folding,_sorting_and_degradation	L3__Sulfur_relay_system
Genetic_Information_Processing.Folding,_sorting_and_degradation.Protein_processing_in_endoplasmic_reticulum	L1__Genetic_Information_Processing	L2__Folding,_sorting_and_degradation	L3__Protein_processing_in_endoplasmic_reticulum
Cellular_Processes.Transport_and_catabolism.Lysosome	L1__Cellular_Processes	L2__Transport_and_catabolism	L3__Lysosome
Cellular_Processes.Transport_and_catabolism.Phagosome	L1__Cellular_Processes	L2__Transport_and_catabolism	L3__Phagosome
Cellular_Processes.Transport_and_catabolism.Peroxisome	L1__Cellular_Processes	L2__Transport_and_catabolism	L3__Peroxisome
Environmental_Information_Processing.Signal_transduction.PI3K__Akt_signaling_pathway	L1__Environmental_Information_Processing	L2__Signal_transduction	L3__PI3K__Akt_signaling_pathway
Environmental_Information_Processing.Signal_transduction.AMPK_signaling_pathway	L1__Environmental_Information_Processing	L2__Signal_transduction	L3__AMPK_signaling_pathway
Cellular_Processes.Cell_growth_and_death.Apoptosis	L1__Cellular_Processes	L2__Cell_growth_and_death	L3__Apoptosis
Organismal_Systems.Aging.Longevity_regulating_pathway	L1__Organismal_Systems	L2__Aging	L3__Longevity_regulating_pathway
Organismal_Systems.Aging.Longevity_regulating_pathway__worm	L1__Organismal_Systems	L2__Aging	L3__Longevity_regulating_pathway__worm
Organismal_Systems.Aging.Longevity_regulating_pathway__multiple_species	L1__Organismal_Systems	L2__Aging	L3__Longevity_regulating_pathway__multiple_species
Cellular_Processes.Cell_growth_and_death.Apoptosis__fly	L1__Cellular_Processes	L2__Cell_growth_and_death	L3__Apoptosis__fly
Cellular_Processes.Cell_growth_and_death.Ferroptosis	L1__Cellular_Processes	L2__Cell_growth_and_death	L3__Ferroptosis
Cellular_Processes.Cell_growth_and_death.Necroptosis	L1__Cellular_Processes	L2__Cell_growth_and_death	L3__Necroptosis
Organismal_Systems.Circulatory_system.Cardiac_muscle_contraction	L1__Organismal_Systems	L2__Circulatory_system	L3__Cardiac_muscle_contraction
Organismal_Systems.Circulatory_system.Adrenergic_signaling_in_cardiomyocytes	L1__Organismal_Systems	L2__Circulatory_system	L3__Adrenergic_signaling_in_cardiomyocytes
Organismal_Systems.Circulatory_system.Vascular_smooth_muscle_contraction	L1__Organismal_Systems	L2__Circulatory_system	L3__Vascular_smooth_muscle_contraction
Environmental_Information_Processing.Signal_transduction.Notch_signaling_pathway	L1__Environmental_Information_Processing	L2__Signal_transduction	L3__Notch_signaling_pathway
Environmental_Information_Processing.Signal_transduction.Hedgehog_signaling_pathway	L1__Environmental_Information_Processing	L2__Signal_transduction	L3__Hedgehog_signaling_pathway
Environmental_Information_Processing.Signal_transduction.TGF__beta_signaling_pathway	L1__Environmental_Information_Processing	L2__Signal_transduction	L3__TGF__beta_signaling_pathway
Organismal_Systems.Development_and_regeneration.Axon_guidance	L1__Organismal_Systems	L2__Development_and_regeneration	L3__Axon_guidance
Organismal_Systems.Development_and_regeneration.Axon_regeneration	L1__Organismal_Systems	L2__Development_and_regeneration	L3__Axon_regeneration
Environmental_Information_Processing.Signal_transduction.Apelin_signaling_pathway	L1__Environmental_Information_Processing	L2__Signal_transduction	L3__Apelin_signaling_pathway
Environmental_Information_Processing.Signal_transduction.Hippo_signaling_pathway	L1__Environmental_Information_Processing	L2__Signal_transduction	L3__Hippo_signaling_pathway
Environmental_Information_Processing.Signal_transduction.Hippo_signaling_pathway__fly	L1__Environmental_Information_Processing	L2__Signal_transduction	L3__Hippo_signaling_pathway__fly
Cellular_Processes.Cellular_community__eukaryotes.Focal_adhesion	L1__Cellular_Processes	L2__Cellular_community__eukaryotes	L3__Focal_adhesion
Environmental_Information_Processing.Signaling_molecules_and_interaction.ECM__receptor_interaction	L1__Environmental_Information_Processing	L2__Signaling_molecules_and_interaction	L3__ECM__receptor_interaction
Environmental_Information_Processing.Signaling_molecules_and_interaction.Cell_adhesion_molecules	L1__Environmental_Information_Processing	L2__Signaling_molecules_and_interaction	L3__Cell_adhesion_molecules
Cellular_Processes.Cellular_community__eukaryotes.Adherens_junction	L1__Cellular_Processes	L2__Cellular_community__eukaryotes	L3__Adherens_junction
Cellular_Processes.Cellular_community__eukaryotes.Tight_junction	L1__Cellular_Processes	L2__Cellular_community__eukaryotes	L3__Tight_junction
Cellular_Processes.Cellular_community__eukaryotes.Gap_junction	L1__Cellular_Processes	L2__Cellular_community__eukaryotes	L3__Gap_junction
Organismal_Systems.Immune_system.Complement_and_coagulation_cascades	L1__Organismal_Systems	L2__Immune_system	L3__Complement_and_coagulation_cascades
Organismal_Systems.Immune_system.Platelet_activation	L1__Organismal_Systems	L2__Immune_system	L3__Platelet_activation
Organismal_Systems.Immune_system.Antigen_processing_and_presentation	L1__Organismal_Systems	L2__Immune_system	L3__Antigen_processing_and_presentation
Organismal_Systems.Immune_system.Neutrophil_extracellular_trap_formation	L1__Organismal_Systems	L2__Immune_system	L3__Neutrophil_extracellular_trap_formation
Organismal_Systems.Immune_system.NOD__like_receptor_signaling_pathway	L1__Organismal_Systems	L2__Immune_system	L3__NOD__like_receptor_signaling_pathway
Organismal_Systems.Immune_system.RIG__I__like_receptor_signaling_pathway	L1__Organismal_Systems	L2__Immune_system	L3__RIG__I__like_receptor_signaling_pathway
Organismal_Systems.Immune_system.Toll_and_Imd_signaling_pathway	L1__Organismal_Systems	L2__Immune_system	L3__Toll_and_Imd_signaling_pathway
Organismal_Systems.Immune_system.IL__17_signaling_pathway	L1__Organismal_Systems	L2__Immune_system	L3__IL__17_signaling_pathway
Organismal_Systems.Immune_system.Th1_and_Th2_cell_differentiation	L1__Organismal_Systems	L2__Immune_system	L3__Th1_and_Th2_cell_differentiation
Organismal_Systems.Immune_system.B_cell_receptor_signaling_pathway	L1__Organismal_Systems	L2__Immune_system	L3__B_cell_receptor_signaling_pathway
Environmental_Information_Processing.Signal_transduction.TNF_signaling_pathway	L1__Environmental_Information_Processing	L2__Signal_transduction	L3__TNF_signaling_pathway
Organismal_Systems.Immune_system.Leukocyte_transendothelial_migration	L1__Organismal_Systems	L2__Immune_system	L3__Leukocyte_transendothelial_migration
Organismal_Systems.Environmental_adaptation.Circadian_entrainment	L1__Organismal_Systems	L2__Environmental_adaptation	L3__Circadian_entrainment
Organismal_Systems.Environmental_adaptation.Thermogenesis	L1__Organismal_Systems	L2__Environmental_adaptation	L3__Thermogenesis
Organismal_Systems.Nervous_system.Synaptic_vesicle_cycle	L1__Organismal_Systems	L2__Nervous_system	L3__Synaptic_vesicle_cycle
Organismal_Systems.Nervous_system.Glutamatergic_synapse	L1__Organismal_Systems	L2__Nervous_system	L3__Glutamatergic_synapse
Organismal_Systems.Nervous_system.Serotonergic_synapse	L1__Organismal_Systems	L2__Nervous_system	L3__Serotonergic_synapse
Organismal_Systems.Nervous_system.GABAergic_synapse	L1__Organismal_Systems	L2__Nervous_system	L3__GABAergic_synapse
Organismal_Systems.Nervous_system.Long__term_depression	L1__Organismal_Systems	L2__Nervous_system	L3__Long__term_depression
Organismal_Systems.Sensory_system.Olfactory_transduction	L1__Organismal_Systems	L2__Sensory_system	L3__Olfactory_transduction
Cellular_Processes.Cell_motility.Regulation_of_actin_cytoskeleton	L1__Cellular_Processes	L2__Cell_motility	L3__Regulation_of_actin_cytoskeleton
Organismal_Systems.Endocrine_system.Insulin_signaling_pathway	L1__Organismal_Systems	L2__Endocrine_system	L3__Insulin_signaling_pathway
Organismal_Systems.Endocrine_system.Insulin_secretion	L1__Organismal_Systems	L2__Endocrine_system	L3__Insulin_secretion
Organismal_Systems.Endocrine_system.Ovarian_steroidogenesis	L1__Organismal_Systems	L2__Endocrine_system	L3__Ovarian_steroidogenesis
Organismal_Systems.Endocrine_system.Progesterone__mediated_oocyte_maturation	L1__Organismal_Systems	L2__Endocrine_system	L3__Progesterone__mediated_oocyte_maturation
Organismal_Systems.Endocrine_system.Estrogen_signaling_pathway	L1__Organismal_Systems	L2__Endocrine_system	L3__Estrogen_signaling_pathway
Organismal_Systems.Endocrine_system.Thyroid_hormone_synthesis	L1__Organismal_Systems	L2__Endocrine_system	L3__Thyroid_hormone_synthesis
Organismal_Systems.Endocrine_system.Thyroid_hormone_signaling_pathway	L1__Organismal_Systems	L2__Endocrine_system	L3__Thyroid_hormone_signaling_pathway
Organismal_Systems.Endocrine_system.Adipocytokine_signaling_pathway	L1__Organismal_Systems	L2__Endocrine_system	L3__Adipocytokine_signaling_pathway
Organismal_Systems.Endocrine_system.Oxytocin_signaling_pathway	L1__Organismal_Systems	L2__Endocrine_system	L3__Oxytocin_signaling_pathway
Organismal_Systems.Endocrine_system.Glucagon_signaling_pathway	L1__Organismal_Systems	L2__Endocrine_system	L3__Glucagon_signaling_pathway
Organismal_Systems.Endocrine_system.Regulation_of_lipolysis_in_adipocytes	L1__Organismal_Systems	L2__Endocrine_system	L3__Regulation_of_lipolysis_in_adipocytes
Organismal_Systems.Endocrine_system.Renin_secretion	L1__Organismal_Systems	L2__Endocrine_system	L3__Renin_secretion
Organismal_Systems.Endocrine_system.Aldosterone_synthesis_and_secretion	L1__Organismal_Systems	L2__Endocrine_system	L3__Aldosterone_synthesis_and_secretion
Organismal_Systems.Endocrine_system.Relaxin_signaling_pathway	L1__Organismal_Systems	L2__Endocrine_system	L3__Relaxin_signaling_pathway
Organismal_Systems.Endocrine_system.Parathyroid_hormone_synthesis,_secretion_and_action	L1__Organismal_Systems	L2__Endocrine_system	L3__Parathyroid_hormone_synthesis,_secretion_and_action
Human_Diseases.Endocrine_and_metabolic_disease.Type_II_diabetes_mellitus	L1__Human_Diseases	L2__Endocrine_and_metabolic_disease	L3__Type_II_diabetes_mellitus
Human_Diseases.Endocrine_and_metabolic_disease.Insulin_resistance	L1__Human_Diseases	L2__Endocrine_and_metabolic_disease	L3__Insulin_resistance
Human_Diseases.Endocrine_and_metabolic_disease.Alcoholic_liver_disease	L1__Human_Diseases	L2__Endocrine_and_metabolic_disease	L3__Alcoholic_liver_disease
Human_Diseases.Endocrine_and_metabolic_disease.Type_I_diabetes_mellitus	L1__Human_Diseases	L2__Endocrine_and_metabolic_disease	L3__Type_I_diabetes_mellitus
Organismal_Systems.Excretory_system.Aldosterone__regulated_sodium_reabsorption	L1__Organismal_Systems	L2__Excretory_system	L3__Aldosterone__regulated_sodium_reabsorption
Organismal_Systems.Excretory_system.Endocrine_and_other_factor__regulated_calcium_reabsorption	L1__Organismal_Systems	L2__Excretory_system	L3__Endocrine_and_other_factor__regulated_calcium_reabsorption
Organismal_Systems.Excretory_system.Vasopressin__regulated_water_reabsorption	L1__Organismal_Systems	L2__Excretory_system	L3__Vasopressin__regulated_water_reabsorption
Organismal_Systems.Excretory_system.Proximal_tubule_bicarbonate_reclamation	L1__Organismal_Systems	L2__Excretory_system	L3__Proximal_tubule_bicarbonate_reclamation
Organismal_Systems.Digestive_system.Salivary_secretion	L1__Organismal_Systems	L2__Digestive_system	L3__Salivary_secretion
Organismal_Systems.Digestive_system.Gastric_acid_secretion	L1__Organismal_Systems	L2__Digestive_system	L3__Gastric_acid_secretion
Organismal_Systems.Digestive_system.Pancreatic_secretion	L1__Organismal_Systems	L2__Digestive_system	L3__Pancreatic_secretion
Organismal_Systems.Digestive_system.Carbohydrate_digestion_and_absorption	L1__Organismal_Systems	L2__Digestive_system	L3__Carbohydrate_digestion_and_absorption
Organismal_Systems.Digestive_system.Protein_digestion_and_absorption	L1__Organismal_Systems	L2__Digestive_system	L3__Protein_digestion_and_absorption
Organismal_Systems.Digestive_system.Fat_digestion_and_absorption	L1__Organismal_Systems	L2__Digestive_system	L3__Fat_digestion_and_absorption
Organismal_Systems.Digestive_system.Bile_secretion	L1__Organismal_Systems	L2__Digestive_system	L3__Bile_secretion
Organismal_Systems.Digestive_system.Mineral_absorption	L1__Organismal_Systems	L2__Digestive_system	L3__Mineral_absorption
Organismal_Systems.Digestive_system.Cholesterol_metabolism	L1__Organismal_Systems	L2__Digestive_system	L3__Cholesterol_metabolism
Human_Diseases.Neurodegenerative_disease.Alzheimer_disease	L1__Human_Diseases	L2__Neurodegenerative_disease	L3__Alzheimer_disease
Human_Diseases.Neurodegenerative_disease.Parkinson_disease	L1__Human_Diseases	L2__Neurodegenerative_disease	L3__Parkinson_disease
Human_Diseases.Neurodegenerative_disease.Amyotrophic_lateral_sclerosis	L1__Human_Diseases	L2__Neurodegenerative_disease	L3__Amyotrophic_lateral_sclerosis
Human_Diseases.Neurodegenerative_disease.Huntington_disease	L1__Human_Diseases	L2__Neurodegenerative_disease	L3__Huntington_disease
Human_Diseases.Neurodegenerative_disease.Spinocerebellar_ataxia	L1__Human_Diseases	L2__Neurodegenerative_disease	L3__Spinocerebellar_ataxia
Human_Diseases.Neurodegenerative_disease.Prion_disease	L1__Human_Diseases	L2__Neurodegenerative_disease	L3__Prion_disease
Human_Diseases.Neurodegenerative_disease.Pathways_of_neurodegeneration__multiple_diseases	L1__Human_Diseases	L2__Neurodegenerative_disease	L3__Pathways_of_neurodegeneration__multiple_diseases
Human_Diseases.Substance_dependence.Cocaine_addiction	L1__Human_Diseases	L2__Substance_dependence	L3__Cocaine_addiction
Human_Diseases.Infectious_disease_bacterial.Bacterial_invasion_of_epithelial_cells	L1__Human_Diseases	L2__Infectious_disease_bacterial	L3__Bacterial_invasion_of_epithelial_cells
Cellular_Processes.Cellular_community__prokaryotes.Biofilm_formation__Vibrio_cholerae	L1__Cellular_Processes	L2__Cellular_community__prokaryotes	L3__Biofilm_formation__Vibrio_cholerae
Human_Diseases.Infectious_disease_bacterial.Pathogenic_Escherichia_coli_infection	L1__Human_Diseases	L2__Infectious_disease_bacterial	L3__Pathogenic_Escherichia_coli_infection
Human_Diseases.Infectious_disease_bacterial.Salmonella_infection	L1__Human_Diseases	L2__Infectious_disease_bacterial	L3__Salmonella_infection
Human_Diseases.Infectious_disease_bacterial.Pertussis	L1__Human_Diseases	L2__Infectious_disease_bacterial	L3__Pertussis
Human_Diseases.Infectious_disease_bacterial.Legionellosis	L1__Human_Diseases	L2__Infectious_disease_bacterial	L3__Legionellosis
Human_Diseases.Infectious_disease_parasitic.Chagas_disease	L1__Human_Diseases	L2__Infectious_disease_parasitic	L3__Chagas_disease
Human_Diseases.Infectious_disease_parasitic.Toxoplasmosis	L1__Human_Diseases	L2__Infectious_disease_parasitic	L3__Toxoplasmosis
Human_Diseases.Infectious_disease_bacterial.Staphylococcus_aureus_infection	L1__Human_Diseases	L2__Infectious_disease_bacterial	L3__Staphylococcus_aureus_infection
Human_Diseases.Infectious_disease_bacterial.Tuberculosis	L1__Human_Diseases	L2__Infectious_disease_bacterial	L3__Tuberculosis
Human_Diseases.Infectious_disease_viral.Hepatitis_C	L1__Human_Diseases	L2__Infectious_disease_viral	L3__Hepatitis_C
Human_Diseases.Infectious_disease_viral.Influenza_A	L1__Human_Diseases	L2__Infectious_disease_viral	L3__Influenza_A
Human_Diseases.Infectious_disease_viral.Human_papillomavirus_infection	L1__Human_Diseases	L2__Infectious_disease_viral	L3__Human_papillomavirus_infection
Human_Diseases.Infectious_disease_viral.Herpes_simplex_virus_1_infection	L1__Human_Diseases	L2__Infectious_disease_viral	L3__Herpes_simplex_virus_1_infection
Human_Diseases.Infectious_disease_viral.Epstein__Barr_virus_infection	L1__Human_Diseases	L2__Infectious_disease_viral	L3__Epstein__Barr_virus_infection
Human_Diseases.Infectious_disease_viral.Coronavirus_disease__COVID__19	L1__Human_Diseases	L2__Infectious_disease_viral	L3__Coronavirus_disease__COVID__19
Human_Diseases.Cancer_overview.Pathways_in_cancer	L1__Human_Diseases	L2__Cancer_overview	L3__Pathways_in_cancer
Human_Diseases.Cancer_overview.Viral_carcinogenesis	L1__Human_Diseases	L2__Cancer_overview	L3__Viral_carcinogenesis
Human_Diseases.Cancer_overview.Proteoglycans_in_cancer	L1__Human_Diseases	L2__Cancer_overview	L3__Proteoglycans_in_cancer
Human_Diseases.Cancer_overview.Chemical_carcinogenesis__reactive_oxygen_species	L1__Human_Diseases	L2__Cancer_overview	L3__Chemical_carcinogenesis__reactive_oxygen_species
Human_Diseases.Cancer_specific_types.Prostate_cancer	L1__Human_Diseases	L2__Cancer_specific_types	L3__Prostate_cancer
Human_Diseases.Cancer_specific_types.Bladder_cancer	L1__Human_Diseases	L2__Cancer_specific_types	L3__Bladder_cancer
Human_Diseases.Cancer_specific_types.Small_cell_lung_cancer	L1__Human_Diseases	L2__Cancer_specific_types	L3__Small_cell_lung_cancer
Human_Diseases.Cancer_specific_types.Hepatocellular_carcinoma	L1__Human_Diseases	L2__Cancer_specific_types	L3__Hepatocellular_carcinoma
Human_Diseases.Cancer_overview.Central_carbon_metabolism_in_cancer	L1__Human_Diseases	L2__Cancer_overview	L3__Central_carbon_metabolism_in_cancer
Human_Diseases.Cancer_overview.Choline_metabolism_in_cancer	L1__Human_Diseases	L2__Cancer_overview	L3__Choline_metabolism_in_cancer
Human_Diseases.Immune_disease.Primary_immunodeficiency	L1__Human_Diseases	L2__Immune_disease	L3__Primary_immunodeficiency
Human_Diseases.Cardiovascular_disease.Hypertrophic_cardiomyopathy	L1__Human_Diseases	L2__Cardiovascular_disease	L3__Hypertrophic_cardiomyopathy
Human_Diseases.Cardiovascular_disease.Arrhythmogenic_right_ventricular_cardiomyopathy	L1__Human_Diseases	L2__Cardiovascular_disease	L3__Arrhythmogenic_right_ventricular_cardiomyopathy
Human_Diseases.Cardiovascular_disease.Dilated_cardiomyopathy	L1__Human_Diseases	L2__Cardiovascular_disease	L3__Dilated_cardiomyopathy
Human_Diseases.Cardiovascular_disease.Diabetic_cardiomyopathy	L1__Human_Diseases	L2__Cardiovascular_disease	L3__Diabetic_cardiomyopathy
Human_Diseases.Cardiovascular_disease.Viral_myocarditis	L1__Human_Diseases	L2__Cardiovascular_disease	L3__Viral_myocarditis
Human_Diseases.Cardiovascular_disease.Lipid_and_atherosclerosis	L1__Human_Diseases	L2__Cardiovascular_disease	L3__Lipid_and_atherosclerosis
Human_Diseases.Cardiovascular_disease.Fluid_shear_stress_and_atherosclerosis	L1__Human_Diseases	L2__Cardiovascular_disease	L3__Fluid_shear_stress_and_atherosclerosis
